T_________
_______T__
___T______
__________
______Y___
__Y_______
__________
X_________