T_________
_______T__
___T______
__________
__________
__________
________Y_
X_________